#########################
#.......................#
#.......................#
#.................K.....#
#.......................#
#.......................#
#.....S.................#
#.......................#
#...............#########
#...............#FBFFFFF#
#...............#FFFFFFF#
#...............#FFFFFFF#
#...............DFFFFFFF#
#...............#FFFFFFF#
#########################