#########################
#.......................#
#.......................#
#.................K.....#
#.......................#
#.......................#
#.....S.................#
#.......................#
#...............#########
#...............#.B.....#
#...............#.......#
#...............#.......#
#...............D.......#
#...............#.......#
#########################