#########################
#.......................#
#.......................#
#.......................#
#.......................#
#.......................#
#.....S.................#
#.......................#
#...............#########
#...............#......B#
#...............#.......#
#...............#.......#
#.......................#
#...............#.......#
#########################